##############################
##############################
##############################
##############################
##############################
##############################
##############################
1____________________________2
1____________________________2
1_V___________?____________X_2
##############################
##############################
##############################
##############################
##############################
##############################
##############################
##############################
##############################
##############################